Player,Tm,Opp.,Att.,Made,Miss,Pct.
Alex Khokhlachev,N/A,1,1,1,0,1
Nikita Gusev,N/A,9,9,6,3,0.67
Maksim Mayorov,N/A,2,2,1,1,0.5
Nikolai Prokhorkin,N/A,2,2,1,1,0.5
Patrik Laine,N/A,18,18,9,9,0.5
Brayden Point,N/A,25,25,12,13,0.48
Sergei Zubov,N/A,31,31,13,18,0.42
Evgeny Kuznetsov,N/A,44,44,18,26,0.41
Elias Pettersson,N/A,17,17,7,10,0.41
Tyler Seguin,N/A,62,61,30,31,0.49
Pavel Datsyuk,N/A,100,98,40,58,0.41
Artemi Panarin,N/A,24,23,14,9,0.61
Sidney Crosby,N/A,101,96,39,57,0.41
Joe Colborne,N/A,20,19,8,11,0.42
Viktor Kozlov,N/A,39,37,17,20,0.46
Mats Zuccarello,N/A,56,53,26,27,0.49
T.J. Oshie,N/A,93,88,46,42,0.52
Brock Boeser,N/A,17,16,3,13,0.19
Wojtek Wolski,N/A,62,58,25,33,0.43
Sean Monahan,N/A,46,43,17,26,0.4
Mitchell Marner,N/A,25,23,5,18,0.22
Alexander Radulov,N/A,37,34,13,21,0.38
Jonathan Toews,N/A,110,101,51,50,0.5
Erik Christensen,N/A,60,55,29,26,0.53
Auston Matthews,N/A,24,22,7,15,0.32
Frans Nielsen,N/A,116,105,49,56,0.47
Rob Schremp,N/A,19,17,9,8,0.53
Jeff Hamilton,N/A,18,16,9,7,0.56
Mikko Rantanen,N/A,9,8,3,5,0.38
Patrick Kane,N/A,124,110,47,63,0.43
Milan Hejduk,N/A,68,60,25,35,0.42
Mikkel Boedker,N/A,49,43,14,29,0.33
Claude Giroux,N/A,106,93,28,65,0.3
Mats Sundin,N/A,30,26,11,15,0.42
Mikko Koivu,N/A,125,107,42,65,0.39
Daniel Alfredsson,N/A,69,59,19,40,0.32
Matt Duchene,N/A,68,58,21,37,0.36
Nikita Kucherov,N/A,47,40,13,27,0.33
Zach Parise,N/A,132,112,44,68,0.39
Joe Sakic,N/A,25,21,7,14,0.33
Jason Williams,N/A,42,35,13,22,0.37
Pavol Demitra,N/A,41,34,15,19,0.44
Anze Kopitar,N/A,132,109,41,68,0.38
Alex Ovechkin,N/A,131,108,34,74,0.31
Joe Pavelski,N/A,130,107,42,65,0.39
Mathew Barzal,N/A,22,18,6,12,0.33
Chris Terry,N/A,16,13,5,8,0.38
Sam Gagner,N/A,99,80,25,55,0.31
Jack Eichel,N/A,26,21,6,15,0.29
Filip Forsberg,N/A,46,37,12,25,0.32
Brandon Pirri,N/A,30,24,11,13,0.46
Connor McDavid,N/A,25,20,9,11,0.45
Michael Nylander,N/A,35,28,11,17,0.39
Nikita Filatov,N/A,5,4,1,3,0.25
Kyle Turris,N/A,97,77,28,49,0.36
Jordan Eberle,N/A,87,69,25,44,0.36
Vladimir Tarasenko,N/A,53,42,14,28,0.33
Jason Spezza,N/A,95,75,27,48,0.36
Corey Perry,N/A,127,100,33,67,0.33
Jakob Silfverberg,N/A,60,47,21,26,0.45
Alexei Kovalev,N/A,60,47,19,28,0.4
Ryan Donato,N/A,9,7,4,3,0.57
Jonathan Drouin,N/A,27,21,7,14,0.33
Cam Atkinson,N/A,53,41,15,26,0.37
Bryan Little,N/A,75,58,18,40,0.31
Jonathan Huberdeau,N/A,70,54,16,38,0.3
Gustav Nyquist,N/A,61,47,16,31,0.34
PA Parenteau,N/A,60,46,20,26,0.43
Mika Zibanejad,N/A,68,52,24,28,0.46
Jordan Weal,N/A,17,13,5,8,0.38
Jiri Hudler,N/A,72,55,19,36,0.35
Jussi Jokinen,N/A,126,96,37,59,0.39
Alexander Semin,N/A,66,50,15,35,0.3
Patrick O'Sullivan,N/A,45,34,15,19,0.44
Kris Letang,N/A,90,68,24,44,0.35
Brad Richards,N/A,110,83,31,52,0.37
Alex Galchenyuk,N/A,57,43,12,31,0.28
Miroslav Satan,N/A,48,36,15,21,0.42
Rick Nash,N/A,115,86,32,54,0.37
Daniel Briere,N/A,75,56,22,34,0.39
Aleksander Barkov,N/A,67,50,22,28,0.44
Vincent Trocheck,N/A,51,38,14,24,0.37
Marek Svatos,N/A,47,35,12,23,0.34
Teemu Selanne,N/A,78,58,21,37,0.36
Tyler Ennis,N/A,66,49,16,33,0.33
Patrice Bergeron,N/A,123,90,25,65,0.28
Nathan MacKinnon,N/A,37,27,11,16,0.41
Nolan Patrick,N/A,11,8,3,5,0.38
Kristian Huselius,N/A,50,36,12,24,0.33
David Pastrnak,N/A,32,23,4,19,0.17
Conor Garland,N/A,14,10,5,5,0.5
Kyle Wilson,N/A,7,5,2,3,0.4
Anthony Duclair,N/A,21,15,3,12,0.2
Jake Debrusk,N/A,14,10,2,8,0.2
Ales Kotalik,N/A,62,44,22,22,0.5
Brad Boyes,N/A,124,88,39,49,0.44
Blake Wheeler,N/A,102,72,26,46,0.36
Ondrej Kase,N/A,20,14,7,7,0.5
Patrik Elias,N/A,103,72,25,47,0.35
Rich Peverley,N/A,43,30,9,21,0.3
Matthew Tkachuk,N/A,23,16,7,9,0.44
Brendan Shanahan,N/A,36,25,9,16,0.36
Kevin Fiala,N/A,26,18,3,15,0.17
Adrian Kempe,N/A,16,11,4,7,0.36
Nick Cousins,N/A,32,22,7,15,0.32
Evgeni Malkin,N/A,99,68,23,45,0.34
Joonas Donskoi,N/A,19,13,6,7,0.46
Nigel Dawes,N/A,38,26,11,15,0.42
Nicklas Backstrom,N/A,104,71,27,44,0.38
David Desharnais,N/A,63,43,17,26,0.4
Todd Bertuzzi,N/A,74,50,17,33,0.34
Vincent Lecavalier,N/A,92,62,14,48,0.23
Nicklas Jensen,N/A,3,2,1,1,0.5
Max Comtois,N/A,6,4,2,2,0.5
Nick Schmaltz,N/A,18,12,5,7,0.42
Jason Akeson,N/A,3,2,0,2,0
Sergey Tolchinsky,N/A,3,2,0,2,0
Kevin Stenlund,N/A,3,2,0,2,0
Drake Batherson,N/A,3,2,0,2,0
John Tavares,N/A,95,63,16,47,0.25
Ray Whitney,N/A,56,37,12,25,0.32
Mike Santorelli,N/A,53,35,16,19,0.46
Steve Sullivan,N/A,53,35,11,24,0.31
Alex Tanguay,N/A,91,60,22,38,0.37
Andy McDonald,N/A,75,49,21,28,0.43
Tyler Bozak,N/A,83,54,23,31,0.43
Damien Brunner,N/A,20,13,3,10,0.23
Markus Naslund,N/A,48,31,10,21,0.32
David Perron,N/A,93,60,21,39,0.35
Ryan Johansen,N/A,73,47,15,32,0.32
Thomas Vanek,N/A,115,74,28,46,0.38
Alex Tuch,N/A,14,9,3,6,0.33
Ales Hemsky,N/A,99,63,21,42,0.33
Sam Reinhart,N/A,33,21,7,14,0.33
Mark Letestu,N/A,60,38,15,23,0.39
Bobby Ryan,N/A,103,65,21,44,0.32
Logan Couture,N/A,92,58,24,34,0.41
Ryan Getzlaf,N/A,125,78,28,50,0.36
Paul Kariya,N/A,42,26,12,14,0.46
Mike Richards,N/A,96,59,17,42,0.29
Cal O'Reilly,N/A,23,14,6,8,0.43
Alexander Wennberg,N/A,33,20,6,14,0.3
Ryane Clowe,N/A,76,46,16,30,0.35
Jamie Benn,N/A,81,48,15,33,0.31
Jacob Josefson,N/A,41,24,13,11,0.54
Andreas Athanasiou,N/A,24,14,6,8,0.43
Sebastian Aho,N/A,24,14,3,11,0.21
Tim Connolly,N/A,43,25,6,19,0.24
Shane Doan,N/A,69,40,12,28,0.3
Paul Byron,N/A,35,20,10,10,0.5
Michael Cammalleri,N/A,84,48,17,31,0.35
Johnny Gaudreau,N/A,35,20,5,15,0.25
Troy Terry,N/A,7,4,1,3,0.25
Mike Ribeiro,N/A,111,63,22,41,0.35
Phil Kessel,N/A,127,72,20,52,0.28
Olli Jokinen,N/A,106,60,21,39,0.35
Drew Stafford,N/A,106,60,20,40,0.33
Jason Pominville,N/A,129,73,29,44,0.4
Oliver Bjorkstrand,N/A,16,9,1,8,0.11
Leon Draisaitl,N/A,34,19,8,11,0.42
Nathan Horton,N/A,77,43,12,31,0.28
Brad Marchand,N/A,79,44,9,35,0.2
Henrik Zetterberg,N/A,117,65,16,49,0.25
Linus Omark,N/A,18,10,2,8,0.2
Jeff Skinner,N/A,65,36,6,30,0.17
Kyle Wellwood,N/A,56,31,10,21,0.32
Mike Comrie,N/A,38,21,7,14,0.33
Brian Gionta,N/A,116,64,22,42,0.34
Patrick Sharp,N/A,120,66,21,45,0.32
Ryan O'Reilly,N/A,82,45,15,30,0.33
Steven Reinprecht,N/A,44,24,7,17,0.29
Craig Smith,N/A,77,42,11,31,0.26
Nikolay Goldobin,N/A,11,6,0,6,0
Ryan Spooner,N/A,35,19,4,15,0.21
Antoine Vermette,N/A,107,58,17,41,0.29
Matt Cullen,N/A,115,62,24,38,0.39
Jeff Carter,N/A,110,59,16,43,0.27
James Neal,N/A,103,55,18,37,0.33
Kyle Connor,N/A,15,8,4,4,0.5
Nick Bjugstad,N/A,60,32,11,21,0.34
Taylor Hall,N/A,62,33,8,25,0.24
Kevin Labanc,N/A,17,9,4,5,0.44
Ryan Ellis,N/A,57,30,10,20,0.33
Mike Modano,N/A,57,30,8,22,0.27
Steven Stamkos,N/A,90,47,15,32,0.32
Martin Erat,N/A,98,51,16,35,0.31
Petr Sykora,N/A,54,28,11,17,0.39
Jaccob Slavin,N/A,31,16,4,12,0.25
Rickard Rakell,N/A,47,24,9,15,0.38
Simon Gagne,N/A,51,26,6,20,0.23
Marian Hossa,N/A,108,55,17,38,0.31
Marian Gaborik,N/A,87,44,12,32,0.27
Ryan Kesler,N/A,119,60,15,45,0.25
Brett Sterling,N/A,2,1,1,0,1
Evgeny Svechnikov,N/A,2,1,1,0,1
Ville Koistinen,N/A,12,6,4,2,0.67
Jeremy Roenick,N/A,24,12,6,6,0.5
Ryan Stoa,N/A,4,2,1,1,0.5
Tim Heed,N/A,4,2,1,1,0.5
Saku Koivu,N/A,82,41,15,26,0.37
Lee Stempniak,N/A,98,49,16,33,0.33
Jonathan Marchessault,N/A,30,15,5,10,0.33
David Krejci,N/A,104,52,14,38,0.27
William Nylander,N/A,28,14,3,11,0.21
Tomas Kubalik,N/A,2,1,0,1,0
Andy Miele,N/A,2,1,0,1,0
Roman Cervenka,N/A,2,1,0,1,0
Johan Sundstrom,N/A,2,1,0,1,0
John Quenneville,N/A,4,2,0,2,0
Morgan Frost,N/A,2,1,0,1,0
Gabriel Vilardi,N/A,2,1,0,1,0
Ryan Nugent-Hopkins,N/A,63,31,10,21,0.32
Charlie Coyle,N/A,53,26,9,17,0.35
Doug Weight,N/A,45,22,8,14,0.36
Robert Nilsson,N/A,41,20,8,12,0.4
Kevin Shattenkirk,N/A,76,37,14,23,0.38
Dylan Larkin,N/A,33,16,4,12,0.25
Markus Granlund,N/A,31,15,6,9,0.4
Dustin Brown,N/A,141,68,19,49,0.28
Jakub Voracek,N/A,121,58,18,40,0.31
Clayton Keller,N/A,23,11,2,9,0.18
Eric Perrin,N/A,21,10,2,8,0.2
Sergei Samsonov,N/A,51,24,7,17,0.29
Alex DeBrincat,N/A,15,7,2,5,0.29
Jarome Iginla,N/A,100,46,12,34,0.26
Kyle Okposo,N/A,94,43,14,29,0.33
Stephen Weiss,N/A,92,42,9,33,0.21
Shea Theodore,N/A,22,10,5,5,0.5
Reid Boucher,N/A,11,5,2,3,0.4
Derek Roy,N/A,104,47,14,33,0.3
Jeff Tambellini,N/A,31,14,8,6,0.57
Andrew Ladd,N/A,113,51,18,33,0.35
Brian Rolston,N/A,60,27,10,17,0.37
Jonathan Cheechoo,N/A,40,18,6,12,0.33
Andrei Svechnikov,N/A,9,4,3,1,0.75
Joffrey Lupul,N/A,81,36,14,22,0.39
Ville Peltonen,N/A,27,12,3,9,0.25
Robby Fabbri,N/A,18,8,1,7,0.13
Kyle Palmieri,N/A,61,27,5,22,0.19
Andrei Kostitsyn,N/A,55,24,6,18,0.25
Matt Moulson,N/A,94,41,16,25,0.39
Sven Baertschi,N/A,23,10,2,8,0.2
Tomas Tatar,N/A,65,28,8,20,0.29
Michal Handzus,N/A,98,42,19,23,0.45
Martin StLouis,N/A,91,39,9,30,0.23
Sonny Milano,N/A,7,3,0,3,0
Matt Hendricks,N/A,69,29,11,18,0.38
Lauri Korpikoski,N/A,60,25,7,18,0.28
Petr Prucha,N/A,48,20,4,16,0.2
Maxim Afinogenov,N/A,41,17,6,11,0.35
Mason Raymond,N/A,82,34,9,25,0.26
Pierre-Luc Dubois,N/A,17,7,4,3,0.57
Jamie Lundmark,N/A,22,9,4,5,0.44
Antti Miettinen,N/A,66,27,8,19,0.3
Alexander Steen,N/A,115,47,20,27,0.43
Jamie Langenbrunner,N/A,81,33,13,20,0.39
Max Pacioretty,N/A,87,35,8,27,0.23
Corban Knight,N/A,5,2,1,1,0.5
Joakim Lindstrom,N/A,20,8,2,6,0.25
Riley Nash,N/A,38,15,6,9,0.4
Tanner Pearson,N/A,38,15,3,12,0.2
Matt Read,N/A,59,23,7,16,0.3
Patrick Marleau,N/A,140,54,16,38,0.3
Peter Holland,N/A,39,15,6,9,0.4
Sean Couturier,N/A,78,30,7,23,0.23
Bobby Butler,N/A,13,5,1,4,0.2
Alexander Frolov,N/A,61,23,8,15,0.35
Mark Scheifele,N/A,48,18,9,9,0.5
Josh Leivo,N/A,16,6,2,4,0.33
Brendan Perlini,N/A,16,6,2,4,0.33
Artem Anisimov,N/A,72,27,8,19,0.3
Pierre-Marc Bouchard,N/A,64,24,7,17,0.29
Sam Steel,N/A,8,3,0,3,0
Trent Hunter,N/A,59,22,6,16,0.27
James vanRiemsdyk,N/A,86,32,9,23,0.28
Teddy Purcell,N/A,73,27,7,20,0.26
Michael Ryder,N/A,103,38,6,32,0.16
Tony DeAngelo,N/A,19,7,3,4,0.43
Reilly Smith,N/A,57,21,5,16,0.24
Nazem Kadri,N/A,68,25,5,20,0.2
Alexandre Burrows,N/A,120,44,16,28,0.36
Darcy Tucker,N/A,41,15,4,11,0.27
Ryan Callahan,N/A,93,34,10,24,0.29
Brendan Morrison,N/A,55,20,7,13,0.35
Cory Stillman,N/A,44,16,4,12,0.25
Jesper Bratt,N/A,22,8,2,6,0.25
Evander Kane,N/A,61,22,3,19,0.14
Ryan Potulny,N/A,14,5,3,2,0.6
Robert Lang,N/A,42,15,6,9,0.4
Dan Boyle,N/A,112,40,11,29,0.28
Gilbert Brule,N/A,42,15,4,11,0.27
Jack Johnson,N/A,115,41,13,28,0.32
Nick Bonino,N/A,73,26,9,17,0.35
Bo Horvat,N/A,45,16,3,13,0.19
Gabriel Landeskog,N/A,51,18,5,13,0.28
Cody Hodgson,N/A,54,19,6,13,0.32
Nathan Gerbe,N/A,54,19,5,14,0.26
Dean McAmmond,N/A,43,15,4,11,0.27
Jason Blake,N/A,66,23,7,16,0.3
Marco Sturm,N/A,78,27,8,19,0.3
Teuvo Teravainen,N/A,29,10,3,7,0.3
Dany Heatley,N/A,102,35,6,29,0.17
Loui Eriksson,N/A,129,44,10,34,0.23
Chris Stewart,N/A,83,28,12,16,0.43
Ryan Smyth,N/A,95,32,8,24,0.25
Jeremy Williams,N/A,3,1,1,0,1
Lucas Lessio,N/A,6,2,1,1,0.5
Sven Andrighetto,N/A,15,5,2,3,0.4
Charlie McAvoy,N/A,15,5,2,3,0.4
Vinnie Hinostroza,N/A,18,6,2,4,0.33
Derek Stepan,N/A,78,26,8,18,0.31
Pontus Aberg,N/A,12,4,1,3,0.25
Rostislav Olesz,N/A,54,18,3,15,0.17
Krystofer Kolanos,N/A,6,2,0,2,0
Alexandre Giroux,N/A,3,1,0,1,0
Brody Sutter,N/A,3,1,0,1,0
Victor Olofsson,N/A,3,1,0,1,0
Ilya Mikheyev,N/A,3,1,0,1,0
Janne Kuokkanen,N/A,3,1,0,1,0
Mikhail Grabovski,N/A,82,27,8,19,0.3
Oliver Ekman-Larsson,N/A,58,19,4,15,0.21
David Legwand,N/A,101,33,10,23,0.3
Kris Versteeg,N/A,92,30,9,21,0.3
Victor Hedman,N/A,80,26,8,18,0.31
Travis Konecny,N/A,34,11,2,9,0.18
Jimmy Vesey,N/A,28,9,3,6,0.33
Brock McGinn,N/A,22,7,4,3,0.57
Devin Setoguchi,N/A,82,26,11,15,0.42
Martin Havlat,N/A,79,25,4,21,0.16
Tuomo Ruutu,N/A,76,24,9,15,0.38
Chris Higgins,N/A,89,28,8,20,0.29
Sergei Fedorov,N/A,35,11,2,9,0.18
Milan Michalek,N/A,94,29,8,21,0.28
Jaromir Jagr,N/A,104,32,7,25,0.22
David Rundblad,N/A,13,4,0,4,0
Seth Griffith,N/A,13,4,0,4,0
Jarkko Ruutu,N/A,59,18,8,10,0.44
Jared McCann,N/A,23,7,3,4,0.43
Tyler Toffoli,N/A,43,13,1,12,0.08
Nikolai Zherdev,N/A,53,16,6,10,0.38
Chris Kunitz,N/A,130,39,14,25,0.36
Tage Thompson,N/A,10,3,1,2,0.33
Brandon Bochenski,N/A,20,6,0,6,0
Brian Flynn,N/A,37,11,5,6,0.45
Brock Nelson,N/A,64,19,6,13,0.32
Owen Nolan,N/A,27,8,2,6,0.25
Rod Brind'Amour,N/A,34,10,4,6,0.4
Danton Heinen,N/A,17,5,0,5,0
Tomas Hertl,N/A,41,12,1,11,0.08
Rene Bourque,N/A,89,26,8,18,0.31
Niklas Hagman,N/A,66,19,5,14,0.26
Eric Staal,N/A,94,27,6,21,0.22
Viktor Tikhonov,N/A,7,2,1,1,0.5
Keith Tkachuk,N/A,42,12,3,9,0.25
Nik Antropov,N/A,56,16,3,13,0.19
Casey Wellman,N/A,7,2,0,2,0
Justin Williams,N/A,116,33,11,22,0.33
Mike Fisher,N/A,94,26,6,20,0.23
Nikolay Kulemin,N/A,87,24,7,17,0.29
Fernando Pisani,N/A,51,14,6,8,0.43
Zemgus Girgensons,N/A,51,14,4,10,0.29
Tim Stapleton,N/A,11,3,2,1,0.67
Nikita Soshnikov,N/A,11,3,1,2,0.33
Ville Leino,N/A,44,12,3,9,0.25
Marc Pouliot,N/A,22,6,1,5,0.17
Nico Hischier,N/A,22,6,0,6,0
Valtteri Filppula,N/A,122,33,8,25,0.24
Josh Bailey,N/A,111,30,10,20,0.33
Frank Vatrano,N/A,26,7,1,6,0.14
Linden Vey,N/A,15,4,1,3,0.25
Adam Henrique,N/A,81,21,3,18,0.14
Mike Hoffman,N/A,66,17,4,13,0.24
Brayden Schenn,N/A,74,19,4,15,0.21
Daniel Sedin,N/A,121,31,5,26,0.16
Jarret Stoll,N/A,137,35,15,20,0.43
J.T. Miller,N/A,47,12,5,7,0.42
Elias Lindholm,N/A,47,12,2,10,0.17
Jere Lehtinen,N/A,51,13,4,9,0.31
Brent Burns,N/A,126,32,10,22,0.31
Mikael Samuelsson,N/A,67,17,3,14,0.18
Lars Eller,N/A,79,20,6,14,0.3
Denis Gurianov,N/A,4,1,1,0,1
Jake Guentzel,N/A,16,4,2,2,0.5
Dominik Kahun,N/A,8,2,1,1,0.5
Kaspars Daugavins,N/A,16,4,1,3,0.25
Fabian Brunnstrom,N/A,16,4,1,3,0.25
Chris Bourque,N/A,8,2,0,2,0
Jonny Brodzinski,N/A,4,1,0,1,0
Michael Amadio,N/A,8,2,0,2,0
Peter Cehlarik,N/A,4,1,0,1,0
Kasperi Kapanen,N/A,12,3,0,3,0
Roope Hintz,N/A,8,2,0,2,0
Miro Heiskanen,N/A,8,2,0,2,0
Bill Guerin,N/A,49,12,5,7,0.42
Anthony Beauvillier,N/A,25,6,2,4,0.33
Tomas Plekanec,N/A,125,30,4,26,0.13
Erik Karlsson,N/A,84,20,5,15,0.25
Marek Zidlicky,N/A,101,24,6,18,0.25
Victor Rask,N/A,38,9,1,8,0.11
Mathieu Perreault,N/A,55,13,2,11,0.15
William Karlsson,N/A,34,8,2,6,0.25
Wayne Simmonds,N/A,129,30,9,21,0.3
Phillip DiGiuseppe,N/A,13,3,1,2,0.33
Matt D'Agostini,N/A,39,9,1,8,0.11
Matt Fraser,N/A,13,3,0,3,0
Alexander Edler,N/A,113,26,6,20,0.23
Shawn Horcoff,N/A,100,23,11,12,0.48
Adrian Aucoin,N/A,48,11,6,5,0.55
Torey Krug,N/A,48,11,2,9,0.18
Travis Zajac,N/A,127,29,6,23,0.21
Alex Chiasson,N/A,53,12,3,9,0.25
Eric Fehr,N/A,80,18,6,12,0.33
P.J. Axelsson,N/A,36,8,2,6,0.25
Matthew Lombardi,N/A,45,10,2,8,0.2
Mark Stone,N/A,54,12,2,10,0.17
Luke Kunin,N/A,9,2,0,2,0
John Mitchell,N/A,59,13,4,9,0.31
Brendan Gallagher,N/A,50,11,2,9,0.18
Nail Yakupov,N/A,32,7,1,6,0.14
Tom Pyatt,N/A,46,10,2,8,0.2
Vaclav Prospal,N/A,74,16,6,10,0.38
Scott Gomez,N/A,121,26,8,18,0.31
Alex Iafallo,N/A,14,3,0,3,0
Tomas Kaberle,N/A,61,13,5,8,0.38
Jakub Vrana,N/A,19,4,2,2,0.5
Todd White,N/A,38,8,3,5,0.38
Pavel Buchnevich,N/A,19,4,0,4,0
Marcel Goc,N/A,91,19,4,15,0.21
Dave Bolland,N/A,68,14,4,10,0.29
Benoit Pouliot,N/A,68,14,3,11,0.21
Erik Haula,N/A,39,8,2,6,0.25
Mark Recchi,N/A,69,14,2,12,0.14
Mika Pyorala,N/A,5,1,1,0,1
Teddy Blueger,N/A,5,1,1,0,1
Sammy Blais,N/A,5,1,1,0,1
Dillon Dube,N/A,5,1,1,0,1
Matt Frattin,N/A,20,4,1,3,0.25
Chris Drury,N/A,75,15,3,12,0.2
Taylor Beck,N/A,10,2,0,2,0
Mike Sislo,N/A,5,1,0,1,0
John Persson,N/A,5,1,0,1,0
Mike Halmo,N/A,5,1,0,1,0
Charles Hudon,N/A,10,2,0,2,0
Andrew Mangiapane,N/A,10,2,0,2,0
Nick Suzuki,N/A,5,1,0,1,0
Quinn Hughes,N/A,10,2,0,2,0
Brooks Laich,N/A,96,19,7,12,0.37
Fredrik Sjostrom,N/A,56,11,4,7,0.36
Troy Brouwer,N/A,113,22,6,16,0.27
Jason Zucker,N/A,36,7,2,5,0.29
Jori Lehtera,N/A,31,6,2,4,0.33
Matt Calvert,N/A,57,11,1,10,0.09
Roman Josi,N/A,73,14,4,10,0.29
Kevin Hayes,N/A,47,9,2,7,0.22
Patrick Eaves,N/A,63,12,5,7,0.42
Jordan Schroeder,N/A,21,4,1,3,0.25
Niclas Bergfors,N/A,21,4,0,4,0
Mattias Tedenby,N/A,16,3,0,3,0
Boone Jenner,N/A,43,8,2,6,0.25
Taylor Pyatt,N/A,70,13,1,12,0.08
Christian Dvorak,N/A,27,5,2,3,0.4
John Madden,N/A,81,15,5,10,0.33
John Klingberg,N/A,27,5,0,5,0
Blair Jones,N/A,22,4,1,3,0.25
Nino Niederreiter,N/A,55,10,2,8,0.2
Dan Sexton,N/A,11,2,0,2,0
Mark Arcobello,N/A,11,2,0,2,0
Robert Thomas,N/A,11,2,0,2,0
Alexander Burmistrov,N/A,28,5,1,4,0.2
Richard Panik,N/A,45,8,1,7,0.13
Ondrej Palat,N/A,45,8,1,7,0.13
David Booth,N/A,79,14,3,11,0.21
Brandon Sutter,N/A,68,12,4,8,0.33
Tyler Bertuzzi,N/A,17,3,0,3,0
Tomas Fleischmann,N/A,91,16,2,14,0.13
Ryan Malone,N/A,80,14,3,11,0.21
Patrik Berglund,N/A,86,15,3,12,0.2
Brandon Montour,N/A,23,4,2,2,0.5
Nick Ritchie,N/A,23,4,1,3,0.25
Max Domi,N/A,23,4,0,4,0
Nikolaj Ehlers,N/A,23,4,0,4,0
David Schlemko,N/A,29,5,2,3,0.4
Dmitrij Jaskin,N/A,29,5,1,4,0.2
Richard Park,N/A,59,10,3,7,0.3
Clarke MacArthur,N/A,83,14,0,14,0
Brian Boyle,N/A,84,14,5,9,0.36
Mattias Ritola,N/A,6,1,0,1,0
Ryan Vesce,N/A,6,1,0,1,0
Zac Dalpe,N/A,12,2,0,2,0
Louis Leblanc,N/A,12,2,0,2,0
Phil Varone,N/A,6,1,0,1,0
Kenny Agostino,N/A,6,1,0,1,0
Martin Frk,N/A,12,2,0,2,0
Austin Czarnik,N/A,6,1,0,1,0
Joshua Ho-Sang,N/A,6,1,0,1,0
Joseph Blandisi,N/A,6,1,0,1,0
Thomas Chabot,N/A,12,2,0,2,0
Raffi Torres,N/A,73,12,5,7,0.42
Ryan Strome,N/A,50,8,2,6,0.25
Chris Tierney,N/A,32,5,1,4,0.2
Eric Belanger,N/A,64,10,1,9,0.1
Damon Severson,N/A,45,7,2,5,0.29
Vernon Fiddler,N/A,84,13,4,9,0.31
Dominic Moore,N/A,110,17,6,11,0.35
Mike Kostka,N/A,13,2,1,1,0.5
Melker Karlsson,N/A,26,4,2,2,0.5
Teemu Hartikainen,N/A,13,2,0,2,0
Filip Chytil,N/A,13,2,0,2,0
Derick Brassard,N/A,98,15,2,13,0.13
Brandon Dubinsky,N/A,106,16,4,12,0.25
Andrei Markov,N/A,93,14,5,9,0.36
Brandon Yip,N/A,20,3,1,2,0.33
Joel Armia,N/A,20,3,1,2,0.33
Mikael Granlund,N/A,47,7,1,6,0.14
Maxim Lapierre,N/A,81,12,6,6,0.5
Evgeny Artyukhin,N/A,27,4,1,3,0.25
Anton Lander,N/A,27,4,0,4,0
Tomas Jurco,N/A,27,4,0,4,0
Sam Bennett,N/A,27,4,0,4,0
Chuck Kobasew,N/A,61,9,0,9,0
Adam Hall,N/A,68,10,3,7,0.3
Daniel Carr,N/A,7,1,1,0,1
Daniel Sprong,N/A,7,1,1,0,1
Andreas Johnsson,N/A,7,1,1,0,1
Mikhail Grigorenko,N/A,14,2,1,1,0.5
Beau Bennett,N/A,21,3,1,2,0.33
Pavel Zacha,N/A,28,4,1,3,0.25
Oscar Moller,N/A,14,2,0,2,0
Carter Ashton,N/A,7,1,0,1,0
Cory Conacher,N/A,21,3,0,3,0
Alan Quine,N/A,7,1,0,1,0
Dmytro Timashov,N/A,7,1,0,1,0
Brady Tkachuk,N/A,7,1,0,1,0
Shayne Gostisbehere,N/A,43,6,1,5,0.17
Curtis Glencross,N/A,65,9,2,7,0.22
Pascal Dupuis,N/A,88,12,4,8,0.33
Sean Bergenheim,N/A,74,10,1,9,0.1
Brandon Saad,N/A,67,9,1,8,0.11
Johan Franzen,N/A,82,11,2,9,0.18
Gabriel Bourque,N/A,45,6,1,5,0.17
David Jones,N/A,53,7,0,7,0
Carl Soderberg,N/A,46,6,1,5,0.17
Mark Parrish,N/A,46,6,0,6,0
Guillaume Latendresse,N/A,54,7,1,6,0.14
Erik Cole,N/A,78,10,1,9,0.1
Michael Frolik,N/A,118,15,2,13,0.13
Stephane DaCosta,N/A,8,1,1,0,1
Tomas Vincour,N/A,16,2,1,1,0.5
Josh Jooris,N/A,16,2,1,1,0.5
Rocco Grimaldi,N/A,16,2,1,1,0.5
Mikhail Sergachev,N/A,16,2,1,1,0.5
Andrew Shaw,N/A,64,8,2,6,0.25
Jordie Benn,N/A,40,5,1,4,0.2
Jimmy Hayes,N/A,48,6,1,5,0.17
Ty Rattie,N/A,8,1,0,1,0
Drew Shore,N/A,8,1,0,1,0
Stefan Matteau,N/A,8,1,0,1,0
Viktor Arvidsson,N/A,32,4,0,4,0
Evgeny Medvedev,N/A,8,1,0,1,0
Mark Jankowski,N/A,16,2,0,2,0
Roman Lyubimov,N/A,8,1,0,1,0
Michael Rasmussen,N/A,8,1,0,1,0
Colin White,N/A,8,1,0,1,0
Dustin Penner,N/A,98,12,1,11,0.08
David Clarkson,N/A,82,10,4,6,0.4
Derek Ryan,N/A,25,3,1,2,0.33
Zack Kassian,N/A,59,7,1,6,0.14
Cam Fowler,N/A,76,9,3,6,0.33
Nick Foligno,N/A,94,11,0,11,0
Kimmo Timonen,N/A,77,9,2,7,0.22
Colton Sceviour,N/A,43,5,2,3,0.4
James Wisniewski,N/A,69,8,3,5,0.38
Sergei Kostitsyn,N/A,52,6,1,5,0.17
Martin St-Pierre,N/A,9,1,1,0,1
Blake Coleman,N/A,27,3,1,2,0.33
Conor Sheary,N/A,27,3,1,2,0.33
Trevor Smith,N/A,9,1,0,1,0
Michal Repik,N/A,9,1,0,1,0
Bryan Rodney,N/A,9,1,0,1,0
Zach Boychuk,N/A,9,1,0,1,0
Ryan Hamilton,N/A,9,1,0,1,0
J.T. Compher,N/A,9,1,0,1,0
Zach Werenski,N/A,18,2,0,2,0
Tyson Jost,N/A,9,1,0,1,0
Joe Thornton,N/A,137,15,5,10,0.33
Mike Knuble,N/A,64,7,2,5,0.29
Calle Jarnkrok,N/A,46,5,1,4,0.2
Jochen Hecht,N/A,74,8,4,4,0.5
Tyson Barrie,N/A,47,5,1,4,0.2
Nic Dowd,N/A,19,2,0,2,0
Valeri Nichushkin,N/A,19,2,0,2,0
Scottie Upshall,N/A,86,9,1,8,0.11
Magnus Paajarvi,N/A,48,5,0,5,0
Ryan Dzingel,N/A,29,3,0,3,0
Mikael Backlund,N/A,69,7,0,7,0
Roman Horak,N/A,10,1,1,0,1
Tye McGinn,N/A,10,1,1,0,1
Chris Wagner,N/A,30,3,1,2,0.33
Michael Raffl,N/A,60,6,1,5,0.17
Boyd Gordon,N/A,70,7,1,6,0.14
Barclay Goodrow,N/A,20,2,0,2,0
Markus Hannikainen,N/A,10,1,0,1,0
Dominik Simon,N/A,10,1,0,1,0
Artturi Lehkonen,N/A,20,2,0,2,0
Jack Roslovic,N/A,10,1,0,1,0
Jason Chimera,N/A,121,12,2,10,0.17
Viktor Stalberg,N/A,71,7,2,5,0.29
Colin Wilson,N/A,71,7,1,6,0.14
Dougie Hamilton,N/A,51,5,3,2,0.6
Kevin Porter,N/A,31,3,1,2,0.33
Dmitry Kulikov,N/A,94,9,2,7,0.22
Justin Fontaine,N/A,21,2,1,1,0.5
Fedor Tyutin,N/A,116,11,4,7,0.36
Riley Sheahan,N/A,53,5,2,3,0.4
Dan Cleary,N/A,85,8,0,8,0
Steve Ott,N/A,117,11,4,7,0.36
Cal Clutterbuck,N/A,109,10,2,8,0.2
Rasmus Dahlin,N/A,11,1,1,0,1
Noah Hanifin,N/A,33,3,1,2,0.33
Andrej Nestrasil,N/A,11,1,0,1,0
Devon Toews,N/A,11,1,0,1,0
Tobias Rieder,N/A,34,3,0,3,0
Drew Doughty,N/A,114,10,2,8,0.2
Paul Stastny,N/A,103,9,0,9,0
Bryan Rust,N/A,23,2,2,0,1
Jason Arnott,N/A,69,6,3,3,0.5
Steve Downie,N/A,46,4,0,4,0
Micheal Ferland,N/A,23,2,0,2,0
Tomas Kopecky,N/A,93,8,3,5,0.38
Enver Lisin,N/A,12,1,0,1,0
Brian Gibbons,N/A,24,2,0,2,0
Matt Puempel,N/A,12,1,0,1,0
Iiro Pakarinen,N/A,12,1,0,1,0
Evan Rodrigues,N/A,12,1,0,1,0
Anthony Cirelli,N/A,12,1,0,1,0
Zdeno Chara,N/A,133,11,3,8,0.27
Brenden Morrow,N/A,85,7,3,4,0.43
Marty Reasoner,N/A,73,6,1,5,0.17
Trevor Lewis,N/A,73,6,1,5,0.17
Kamil Kreps,N/A,37,3,1,2,0.33
Ben Smith,N/A,38,3,1,2,0.33
Mike Green,N/A,102,8,0,8,0
Dustin Byfuglien,N/A,102,8,0,8,0
Jeremy Morin,N/A,13,1,1,0,1
Vladislav Namestnikov,N/A,39,3,1,2,0.33
David Backes,N/A,117,9,2,7,0.22
Brendan Bell,N/A,13,1,0,1,0
Luke Adam,N/A,13,1,0,1,0
Ryan Garbutt,N/A,26,2,0,2,0
Alexander Kerfoot,N/A,13,1,0,1,0
Mike Reilly,N/A,13,1,0,1,0
Dylan Strome,N/A,13,1,0,1,0
Marcus Foligno,N/A,66,5,0,5,0
Tyler Johnson,N/A,53,4,0,4,0
Patric Hornqvist,N/A,81,6,0,6,0
Cody Franson,N/A,68,5,1,4,0.2
Darren Helm,N/A,82,6,2,4,0.33
Anders Lee,N/A,55,4,0,4,0
Dustin Jeffrey,N/A,14,1,1,0,1
Zach Redmond,N/A,14,1,0,1,0
Stefan Noesen,N/A,14,1,0,1,0
Zach Sanford,N/A,14,1,0,1,0
Dwight King,N/A,43,3,2,1,0.67
Andrew Ebbett,N/A,29,2,1,1,0.5
Jean-Pierre Dumont,N/A,58,4,1,3,0.25
Chad LaRose,N/A,44,3,1,2,0.33
Jiri Tlusty,N/A,44,3,0,3,0
Marcus Johansson,N/A,74,5,0,5,0
Timo Meier,N/A,15,1,1,0,1
Jeff Taffe,N/A,15,1,0,1,0
Michael Latta,N/A,15,1,0,1,0
Matt Tennyson,N/A,15,1,0,1,0
Jujhar Khaira,N/A,15,1,0,1,0
Oskar Lindblom,N/A,15,1,0,1,0
Richard Zednik,N/A,31,2,1,1,0.5
Evgenii Dadonov,N/A,31,2,0,2,0
Scott Laughton,N/A,31,2,0,2,0
Scott Parse,N/A,16,1,0,1,0
Tim Kennedy,N/A,16,1,0,1,0
Matt Halischuk,N/A,32,2,0,2,0
Brandon Segal,N/A,16,1,0,1,0
Dmitry Orlov,N/A,48,3,0,3,0
Adam Gaudette,N/A,16,1,0,1,0
Radek Bonk,N/A,33,2,0,2,0
Colby Armstrong,N/A,51,3,2,1,0.67
Keith Aucoin,N/A,17,1,0,1,0
Alexander Sulzer,N/A,17,1,0,1,0
Simon Despres,N/A,17,1,0,1,0
Mark Streit,N/A,103,6,0,6,0
Dion Phaneuf,N/A,121,7,0,7,0
Jaden Schwartz,N/A,52,3,0,3,0
Michal Rozsival,N/A,106,6,1,5,0.17
Henrik Sedin,N/A,124,7,0,7,0
Josh Anderson,N/A,18,1,1,0,1
Benn Ferriero,N/A,18,1,0,1,0
Anthony Peluso,N/A,18,1,0,1,0
Brendan Leipsic,N/A,18,1,0,1,0
Yanni Gourde,N/A,18,1,0,1,0
Tyler Myers,N/A,73,4,1,3,0.25
James Sheppard,N/A,56,3,0,3,0
Alex Goligoski,N/A,95,5,2,3,0.4
Tyler Kennedy,N/A,76,4,0,4,0
Oscar Lindberg,N/A,19,1,0,1,0
Mattias Janmark,N/A,19,1,0,1,0
Anthony Mantha,N/A,19,1,0,1,0
Stephane Robidas,N/A,98,5,1,4,0.2
Tommy Wingels,N/A,59,3,1,2,0.33
T.J. Brodie,N/A,59,3,0,3,0
Rob Klinkhammer,N/A,20,1,1,0,1
Devante Smith-Pelly,N/A,40,2,1,1,0.5
Antoine Roussel,N/A,40,2,1,1,0.5
Kurtis Foster,N/A,60,3,0,3,0
Derrick Pouliot,N/A,20,1,0,1,0
Ryan Hartman,N/A,20,1,0,1,0
Matt Carle,N/A,82,4,2,2,0.5
Chris Wideman,N/A,21,1,0,1,0
Logan Shaw,N/A,21,1,0,1,0
Patrick Wiercioch,N/A,43,2,0,2,0
P.K. Subban,N/A,88,4,0,4,0
Brad Winchester,N/A,45,2,1,1,0.5
Dylan Olsen,N/A,23,1,1,0,1
Bryan Bickell,N/A,69,3,1,2,0.33
Andre Burakovsky,N/A,23,1,0,1,0
Marcus Kruger,N/A,70,3,0,3,0
Jeff Halpern,N/A,71,3,1,2,0.33
Casey Cizikas,N/A,71,3,1,2,0.33
Shawn Matthias,N/A,71,3,0,3,0
Colin McDonald,N/A,24,1,1,0,1
Emerson Etem,N/A,24,1,1,0,1
Sami Salo,N/A,72,3,1,2,0.33
Chris Conner,N/A,24,1,0,1,0
Raphael Diaz,N/A,24,1,0,1,0
Jakob Chychrun,N/A,24,1,0,1,0
Pat Maroon,N/A,49,2,0,2,0
Justin Schultz,N/A,49,2,0,2,0
Vladimir Sobotka,N/A,74,3,0,3,0
Trevor Daley,N/A,124,5,1,4,0.2
Jake Virtanen,N/A,25,1,1,0,1
Rasmus Ristolainen,N/A,50,2,1,1,0.5
T.J. Galiardi,N/A,50,2,0,2,0
Will Butcher,N/A,25,1,0,1,0
Denis Malgin,N/A,25,1,0,1,0
Erik Johnson,N/A,76,3,0,3,0
Martin Marincin,N/A,26,1,1,0,1
Dustin Boyd,N/A,26,1,0,1,0
R.J. Umberger,N/A,104,4,0,4,0
Erik Condra,N/A,52,2,0,2,0
Connor Brown,N/A,26,1,0,1,0
Blake Comeau,N/A,79,3,1,2,0.33
Matt Niskanen,N/A,107,4,1,3,0.25
Jannik Hansen,N/A,81,3,0,3,0
Derek Grant,N/A,27,1,0,1,0
Zack Smith,N/A,81,3,0,3,0
Patrick Kaleta,N/A,55,2,0,2,0
Alex Killorn,N/A,55,2,0,2,0
Peter Regin,N/A,28,1,1,0,1
Matt Gilroy,N/A,28,1,0,1,0
John Carlson,N/A,85,3,1,2,0.33
Morgan Rielly,N/A,57,2,0,2,0
Thomas Hickey,N/A,58,2,1,1,0.5
Joel Ward,N/A,87,3,1,2,0.33
Kevin Connauton,N/A,29,1,0,1,0
Matt Dumba,N/A,29,1,0,1,0
Yannick Weber,N/A,59,2,1,1,0.5
Niklas Kronwall,N/A,118,4,1,3,0.25
Mike Matheson,N/A,30,1,1,0,1
Mattias Ohlund,N/A,60,2,1,1,0.5
Tim Schaller,N/A,30,1,0,1,0
Ben Hutton,N/A,30,1,0,1,0
Aaron Ekblad,N/A,60,2,0,2,0
Justin Abdelkader,N/A,91,3,1,2,0.33
Matt Beleskey,N/A,61,2,0,2,0
Andrei Loktionov,N/A,31,1,0,1,0
Jay Beagle,N/A,62,2,0,2,0
Anton Stralman,N/A,94,3,0,3,0
Pavel Kubina,N/A,63,2,0,2,0
Jiri Novotny,N/A,32,1,0,1,0
Kevin Bieksa,N/A,99,3,0,3,0
Jared Spurgeon,N/A,66,2,0,2,0
Andrew Cogliano,N/A,134,4,0,4,0
Maxime Talbot,N/A,102,3,1,2,0.33
Nick Leddy,N/A,102,3,1,2,0.33
Matt Bradley,N/A,68,2,0,2,0
Andrew Brunette,N/A,69,2,0,2,0
Jake Gardiner,N/A,70,2,0,2,0
Ivan Provorov,N/A,35,1,0,1,0
Lubomir Visnovsky,N/A,75,2,1,1,0.5
Jamie McBain,N/A,38,1,0,1,0
Tom Wandell,N/A,38,1,0,1,0
Josh Manson,N/A,38,1,0,1,0
Brett Connolly,N/A,38,1,0,1,0
Oscar Klefbom,N/A,38,1,0,1,0
Milan Lucic,N/A,115,3,0,3,0
Nate Schmidt,N/A,39,1,0,1,0
Kyle Brodziak,N/A,118,3,1,2,0.33
Jordan Leopold,N/A,79,2,1,1,0.5
Samuel Pahlsson,N/A,79,2,0,2,0
Joakim Nordstrom,N/A,40,1,0,1,0
Steve Bernier,N/A,81,2,1,1,0.5
Derek MacKenzie,N/A,81,2,1,1,0.5
Colin Greening,N/A,41,1,0,1,0
Toni Lydman,N/A,83,2,1,1,0.5
Jonathan Sim,N/A,42,1,0,1,0
Ryan Johnson,N/A,42,1,0,1,0
Chris Clark,N/A,43,1,1,0,1
Daymond Langkow,N/A,43,1,0,1,0
Paul Ranger,N/A,43,1,0,1,0
Alex Pietrangelo,N/A,86,2,0,2,0
Matt Nieto,N/A,43,1,0,1,0
Travis Moen,N/A,87,2,0,2,0
Drew Miller,N/A,89,2,1,1,0.5
Dan Carcillo,N/A,45,1,1,0,1
Brendan Witt,N/A,45,1,0,1,0
Cody Eakin,N/A,45,1,0,1,0
Matt Martin,N/A,91,2,0,2,0
Kris Russell,N/A,94,2,0,2,0
Cody McCormick,N/A,48,1,0,1,0
Jean-Gabriel Pageau,N/A,48,1,0,1,0
Chris Kelly,N/A,97,2,0,2,0
Sami Vatanen,N/A,50,1,1,0,1
Matt Irwin,N/A,50,1,0,1,0
Chris Kreider,N/A,50,1,0,1,0
Seth Jones,N/A,50,1,0,1,0
Matt Stajan,N/A,103,2,0,2,0
Tom Gilbert,N/A,103,2,0,2,0
Cam Barker,N/A,52,1,0,1,0
Justin Faulk,N/A,53,1,0,1,0
Tom Wilson,N/A,53,1,0,1,0
Mark Pysyk,N/A,54,1,0,1,0
Scott Niedermayer,N/A,55,1,0,1,0
Steve Montador,N/A,55,1,0,1,0
Leo Komarov,N/A,55,1,0,1,0
Kris Draper,N/A,56,1,0,1,0
Cody Ceci,N/A,56,1,0,1,0
Carl Hagelin,N/A,57,1,0,1,0
Derek Dorsett,N/A,58,1,0,1,0
Hampus Lindholm,N/A,58,1,0,1,0
Mattias Ekholm,N/A,59,1,0,1,0
Jay McClement,N/A,120,2,1,1,0.5
Colin Fraser,N/A,60,1,0,1,0
Sheldon Souray,N/A,61,1,0,1,0
Rob Niedermayer,N/A,62,1,0,1,0
Brendan Smith,N/A,62,1,0,1,0
Adam Larsson,N/A,62,1,0,1,0
Adam Mair,N/A,63,1,0,1,0
Tomas Holmstrom,N/A,63,1,0,1,0
Ryan Carter,N/A,63,1,0,1,0
Zach Bogosian,N/A,64,1,1,0,1
Chris Pronger,N/A,64,1,0,1,0
Stephane Veilleux,N/A,66,1,0,1,0
Jeff Petry,N/A,68,1,0,1,0
Erik Gudbranson,N/A,71,1,0,1,0
Francis Bouillon,N/A,75,1,0,1,0
Henrik Tallinder,N/A,77,1,0,1,0
Jamie McGinn,N/A,77,1,0,1,0
Karl Alzner,N/A,77,1,0,1,0
Carl Gunnarsson,N/A,79,1,0,1,0
Andrej Meszaros,N/A,80,1,0,1,0
Michael DelZotto,N/A,80,1,0,1,0
Michael Grabner,N/A,83,1,0,1,0
Nate Thompson,N/A,83,1,0,1,0
Johnny Boychuk,N/A,84,1,0,1,0
John-Michael Liles,N/A,84,1,0,1,0
Torrey Mitchell,N/A,86,1,0,1,0
Christian Ehrhoff,N/A,88,1,0,1,0
Mark Giordano,N/A,89,1,0,1,0
Keith Yandle,N/A,90,1,0,1,0
Manny Malhotra,N/A,96,1,0,1,0
Dainius Zubrus,N/A,97,1,0,1,0
Chris Neil,N/A,97,1,0,1,0
Willie Mitchell,N/A,98,1,0,1,0
Jason Demers,N/A,104,1,0,1,0
Brad Richardson,N/A,105,1,0,1,0
Scott Hartnell,N/A,105,1,0,1,0
Francois Beauchemin,N/A,105,1,0,1,0
Niklas Hjalmarsson,N/A,107,1,0,1,0
Brooks Orpik,N/A,108,1,1,0,1
Shea Weber,N/A,108,1,0,1,0
Marc Staal,N/A,111,1,0,1,0
Marc-Edouard Vlasic,N/A,129,1,0,1,0
Jay Bouwmeester,N/A,134,1,0,1,0
Brent Seabrook,N/A,142,1,1,0,1
Brian Campbell,N/A,143,1,0,1,0
